#################
#################
##------------2##
##-#-#@#-#@#-#-##
##-#---------#-##
##-#*#-#-#-#*#-##
##-#-#-----#-#-##
##------*------##
###-#--*@*--#-###
##------*------##
##-#-#-----#-#-##
##-#*#-#-#-#*#-##
##-#---------#-##
##-#-#@#-#@#-#-##
##1------------##
#################
#################
